111111111111111
10000C00C000001
100P000C000E001
10000C00C000001
111111111111111