111111111111111
1000000C0000001
100P0000000E001
1000000C0000001
111111111111111