111111111111111
1000P00C001C001
10C00E0Q0010001
100000000000001
111111111111111