111111111111111
10000000000E001
100P000C0000001
10000000000E001
111111111111111