111111111111111
100000000000001
1000000C000E001
100000000000001
111111111111111