11111111111111
100000000000001
100P00C0000E001
100000000000001
111111111111111