111111111111111
100000000100001
100P000C010E001
100000000100001
111111111111111