111111111110111
10QWERTY0000001
100P000C000E001
100000000000001
111111111111111